a = 4, @, /-\, /\, ^, Д
b = ß, |3, I3, 13, !3, )3
c = (, <
d = |), |)
e = €,
f = |=,
g = #, #
h = #, #
i = #, #
j = #, #
k = #, #
l = #, #
m = #, #
n = #, #
o = #, #
p = #, #
q = #, #
r = #, #
s = #, #
t = #, #
u = #, #
v = #, #
w = #, #
x = #, #
y = #, #
z = #, #
